9 9
3 1
1 1 1 1 1 1 1 1 1
1 0 0 0 1 1 1 1 1
1 0 0 0 1 1 1 1 1
1 0 2 0 1 1 1 3 1
1 1 1 6 1 1 1 0 1
1 1 1 1 0 0 0 0 1
1 1 1 1 0 0 6 0 1
1 1 1 1 0 0 0 0 1
1 1 1 1 1 1 1 1 1 