7 7
2 5
1 1 1 1 1 1 1
1 3 0 6 0 0 1
1 0 1 1 1 0 1
1 2 7 0 7 2 1
1 0 1 1 1 0 1
1 0 0 6 0 3 1
1 1 1 1 1 1 1